1 1 1 1 1 1 1 1 1 1 1 1 1 1 1 1 1 1 1
1 -1 1 2 -2 2 3 0 3 4 0 4 5 0 5 6 0 7 8
1 0 0 0 0 0 0 0 0 0 0 0 0 0 0 0 0 0 0
9 10 11 12 13 14 15 16 17 18
0 -1

0 -2
0 -3
0 0 0 0 0 0 0 0 0 7 8 9 0 0 0 0 0 0 0
7 7 7 7 7 7 7 7 7 7 7 7 7 7 7 7 7 7 0
7 0 0 0 0 0 0 0 7 0 0 0 0 7 0 0 0 0 0
0 0 7 0 0 0 7 0 0 0 7 0 0 0 0 0 0 0 7
0 -1 0 0 0 7 7 7 7 7 7 0 0 0 0 7 7 7 7 7
0 -1 0 0 0 0 7 7 7 7 7 0 0 0 0 7 7 7 7 7
0 -1 0 7 7 7 7 7 7 7 7 7 7 7 7 7 7 7 7 7
0 -1 0 8 8 8 8 8 8 8 8 8 8 8 8 8 8 8 8 8
0 -1 0 0 0 0 0 0 0 0 0 0 0 0 0 0 0 0 0 0
8 8 8 8 8 8 8 8 0 8 8 8 8 8 8 8 8 8 8 8

