10  10  10  10  10 10 10 10 10 10 10 10
10 -1 -2 -2 -1 0 0 0 0 10 0 10
10  0 0  0  0  0 10 10 0 0 10 10
10 10 10 10  10  10  10 10 0 0 10 10
10 10 10 10 10 10 10 10 10 0 0 10 10
6 6 6 6 6 6 6 6 6 0 6 6 6 
6 6 6 6 6 6 6 0 0 0 6 6 6
6 -2 0 6 6 0 6 0 6 6 6 6 6
6 0 0 0 0 0 0 0 6 6 6 6 6
6 6 6 0 6 6 6 0 6 6 6 6 6
7 7 7 7 7 7 7 0 7 7 7 7 7
7 7 7 0 0 0 0 0 0 0 0 0 7
7 7 7 0 7 7 7 7 7 7 7 0 7
8 8 8 0 8 8 8 8 9 9 9 0 9
8 0 0 0 0 0 8 8 9 9 0 0 9
0 0 0 8 8 0 8 8 9 9 0 0 9
8 0 8 0 0 0 8 8 0 0 0 9 0
8 8 8 8 8 0 0 0 0 0 0 0 0
9 9 9 9 9 9 9 9 9 9 9 9 9
